SO ./path_to_the_south_texture
WE ./path_to_the_west_texture
EA ./path_to_the_east_texture
NO ./path_to_the_north_texture
C  225,30,0
F 220,100,0








11111111
10000001
10000E01
10000001
11111111
