SO assets/m64 atlantic.png
WE assets/bowser_2.png
EA assets/bowser3.png
NO assets/egypt.png

F 20,40,40
C 20,20,250

1111111
1W0001
111111