SO ./path_to_the_south_texture
WE ./path_to_the_west_texture
EA ./path_to_the_east_texture
NO ./path_to_the_north_texture

C  225,30,0
F 220,100,0

    111111111111111111111111111111111   
111111111000000000110000000000001
111111111011000001110000000100001
111111111001000000000000000010001
111111111011000001110000000N00001
100000000011000001110111110111111
11110111111111011100000010001
11110111111111011101010010001
11000000110101011100000010001
10000000000000001100000010001
10000000000000001101010010001
110000011101010111110111100111
11110111 1110101 101111010001
11111111 1111111 111111111111
