111111111
100000P01
100100001
100000001
100000001
111111111
