111111111
100000001
100100001
100000001
100000P01
111111111
