SO assets/m64 atlantic.png
WE assets/bowser_2.png
EA assets/bowser3.png
NO assets/egypt.png

C 200,200,260
F 150,95,20

    111111111111111111111111111111111
111111011000000000110000000000001
111111100011000001110000000100001
111111111001000000000000000010001
111111111011000001110000000N00001
100000000011000001110111110111111
11110111111111011100000010001
11110111111111011101010010001
11000000110101011100000010001
10000000000000001100000010001
10000000000000001101010010001
110000011101010111110111100111
11110111 1110101 101111010001
11111111 1111111 111111111111
