SO assets/m64 atlantic.png
WE assets/bowser_2.png
EA assets/bowser3.png
NO assets/egypt.png


F 0, 53,0
C 153,    204,25


111111111111
1000000100001
1000000000001
1000000000001
1000000E00001
111111111111
