111111111111
100000P00001
111100001111
   100000001
111100000001
100000010001
111100000001
111111111111
